method	R	METHOD
model	R	METHOD
algorithm	R	METHOD
methods	L	METHOD
algorithms	R	PROBLEM
techniques	R	PROBLEM
demands	R	PROBLEM
task	R	PROBLEM
tasks	R	PROBLEM
schemes	R	PROBLEM
problem	L	PROBLEM
problems	L	PROBLEM
traditional	L	PROBLEM
device	R	PROBLEM
process	R	PROBLEM
measure	R	METRIC
measure	L	METRIC
measures	R	METRIC
terms	L	METRIC
values	R	METRIC
scores	R	METRIC
number	L	CONCEPT
function	R	CONCEPT
