data_science	PROBLEM	PROBLEM	T
data_mining	PROBLEM	PROBLEM	T
frequent_pattern_mining	PROBLEM	PROBLEM	T
mining_frequent_patterns	PROBLEM	PROBLEM	T
frequent_patterns	CONCEPT	CONCEPT	T
frequent_itemset_mining	PROBLEM	PROBLEM	T
mining_frequent_itemsets	PROBLEM	PROBLEM	T
frequent_itemsets	CONCEPT	CONCEPT	T
apriori	METHOD	METHOD	T
eclat	METHOD	METHOD	T
fp-growth	METHOD	METHOD	T
mining_closed_patterns	PROBLEM	METHOD	F
closed_patterns	CONCEPT	CONCEPT	T
closet	METHOD	METHOD	T
closet_+	METHOD	METHOD	T
sequential_pattern_mining	PROBLEM	PROBLEM	T
mining_sequential_patterns	PROBLEM	PROBLEM	T
GSP	METHOD	METHOD	T
SPADE	METHOD	METHOD	T
prefixspan	METHOD	METHOD	T
subgraph_pattern_mining	PROBLEM	PROBLEM	T
subgraph_mining	PROBLEM	PROBLEM	T
closegraph	METHOD	METHOD	T
gspan	METHOD	METHOD	T
clospan	METHOD	PROBLEM	F
association_rule_mining	PROBLEM	PROBLEM	T
association_mining	PROBLEM	PROBLEM	T
mining_association_rules	PROBLEM	PROBLEM	T
classification	PROBLEM	PROBLEM	T
text_categorization	PROBLEM	PROBLEM	T
image_classification	PROBLEM	PROBLEM	T
face_recognition	PROBLEM	PROBLEM	T
spam_detection	PROBLEM	PROBLEM	T
fraud_detection	PROBLEM	PROBLEM	T
entity_recognition	PROBLEM	PROBLEM	T
relation_extraction	PROBLEM	PROBLEM	T
relational_classification	PROBLEM	PROBLEM	T
relation_classification	PROBLEM	PROBLEM	T
knn	METHOD	METHOD	T
k_nearest_neighbor	METHOD	METHOD	T
decision_trees	METHOD	METHOD	T
decision_tree	METHOD	METHOD	T
CART	METHOD	METHOD	T
gini_index	CONCEPT	METRIC	F
ID3	METHOD	METHOD	T
information_gain	CONCEPT	METRIC	F
C4.5	METHOD	METHOD	T
gain_ratio	CONCEPT	METHOD	F
bayesian_learning	METHOD	METHOD	T
bayes_theorem	CONCEPT	CONCEPT	T
naive_bayes	METHOD	METHOD	T
NB	METHOD	METHOD	T
bayesian_networks	METHOD	METHOD	T
generative_model	METHOD	METHOD	T
MLE	METHOD	METHOD	T
maximum_likelihood_estimation	METHOD	METHOD	T
topic_model	METHOD	METHOD	T
topic_models	METHOD	METHOD	T
LDA	METHOD	METHOD	T
latent_dirichlet_allocation	METHOD	METHOD	T
support_vector_machines	METHOD	METHOD	T
support_vector_machine	METHOD	METHOD	T
svms	METHOD	METHOD	T
svm	METHOD	METHOD	T
linear_svm	METHOD	METHOD	T
kernel_svm	METHOD	METHOD	T
ls-svm	METHOD	METHOD	T
least_squares_support_vector_machine	METHOD	METHOD	T
vmls-svm	METHOD	METHOD	T
libsvm	METHOD	METHOD	T
artificial_neural_networks	METHOD	METHOD	T
neural_networks	METHOD	METHOD	T
activation	CONCEPT	CONCEPT	T
sigmoid	CONCEPT	CONCEPT	T
tanh	CONCEPT	CONCEPT	T
hidden_layer	CONCEPT	CONCEPT	T
hidden_layers	CONCEPT	CONCEPT	T
perceptron	METHOD	METHOD	T
ensembles	METHOD	METHOD	T
ensemble	METHOD	METHOD	T
bagging	METHOD	METHOD	T
random_forests	METHOD	METHOD	T
random_forest	METHOD	METHOD	T
boosting	METHOD	METHOD	T
adaboost	METHOD	METHOD	T
bootstrapping	METHOD	METHOD	T
hold-out_validation	METHOD	METHOD	T
cross_validation	METHOD	METHOD	T
accuracy	METRIC	METRIC	T
specificity	METRIC	METRIC	T
TPR	METRIC	METRIC	T
truepositive_rate	METRIC	METRIC	T
true_positive_rate	METRIC	METRIC	T
sensitivity	METRIC	METRIC	T
FPR	METRIC	METRIC	T
false_positive_rate	METRIC	METRIC	T
false-positive_rate	METRIC	METRIC	T
precision	METRIC	METRIC	T
recall	METRIC	METRIC	T
f_measure	METRIC	METRIC	T
f-measure	METRIC	METRIC	T
f-score	METRIC	METRIC	T
F1	METRIC	METRIC	T
f1_measure	METRIC	METRIC	T
f1-measure	METRIC	METRIC	T
f1_score	METRIC	METRIC	T
f1-score	METRIC	METRIC	T
micro_f1	METRIC	METRIC	T
micro-f1	METRIC	METRIC	T
macro_f1	METRIC	METRIC	T
macro-f1	METRIC	METRIC	T
AUC	METRIC	METRIC	T
area_under_the_curve	METRIC	METRIC	T
area_under_curve	METRIC	METRIC	T
MRR	METRIC	METRIC	T
mean_reciprocal_rank	METRIC	METRIC	T
MAP	METRIC	METRIC	T
mean_average_precision	METRIC	METRIC	T
DCG	METRIC	METRIC	T
discounted_cumulative_gain	METRIC	METRIC	T
discounted_cumulative_gain_measure	METRIC	METRIC	T
NDCG	METRIC	METRIC	T
normalized_discounted_cumulative_gain	METRIC	METRIC	T
normalized_discounted_cumulative_gain_measure	METRIC	METRIC	T
NDCG_@_k	METRIC	METRIC	T
MAE	METRIC	METRIC	T
mean_absolute_error	METRIC	METRIC	T
RMSE	METRIC	METRIC	T
root_mean_squared_error	METRIC	METRIC	T
root_mean_square_error	METRIC	METRIC	T
root-mean-square_error	METRIC	METRIC	T
robustness	METRIC	METHOD	F
binary_classification	PROBLEM	PROBLEM	T
multi-class_classification	PROBLEM	PROBLEM	T
multi-label_classification	PROBLEM	PROBLEM	T
multiclass_classification	PROBLEM	PROBLEM	T
multilabel_classification	PROBLEM	PROBLEM	T
regression	PROBLEM	PROBLEM	T
regression_analysis	PROBLEM	PROBLEM	T
linear_regression	METHOD	METHOD	T
non-linear_regression	METHOD	METHOD	T
logistic_regression	METHOD	METHOD	T
gaussian_process_regression	METHOD	METHOD	T
SVR	METHOD	METHOD	T
support_vector_regression	METHOD	METHOD	T
multivariate_regression	METHOD	METHOD	T
clustering	PROBLEM	PROBLEM	T
cluster_analysis	PROBLEM	METHOD	F
community_detection	PROBLEM	PROBLEM	T
document_clustering	PROBLEM	PROBLEM	T
k-partitioning	METHOD	METHOD	T
k-means_clustering	METHOD	METHOD	T
k-means	METHOD	METHOD	T
kernel_k-means	METHOD	METHOD	T
k-medoids_clustering	METHOD	METHOD	T
k-medoids	METHOD	METHOD	T
density-based_clustering	METHOD	METHOD	T
dbscan	METHOD	METHOD	T
hierarchical_clustering	METHOD	METHOD	T
spectral_clustering	METHOD	METHOD	T
principal_component_analysis	METHOD	METHOD	T
principal_components_analysis	METHOD	METHOD	T
PCA	METHOD	METHOD	T
principal_components	CONCEPT	METHOD	F
singular_value_decomposition	METHOD	METHOD	T
SVD	METHOD	METHOD	T
matrix_factorization	METHOD	METHOD	T
gradient_descent	METHOD	METHOD	T
SGD	METHOD	METHOD	T
stochastic_gradient_descent	METHOD	METHOD	T
CSGD	METHOD	METHOD	T
constrained_stochastic_gradient_descent	METHOD	METHOD	T
coordinate_descent	METHOD	METHOD	T
dual_coordinate_descent	METHOD	METHOD	T
block_coordinate_gradient_descent	METHOD	METHOD	T
NMF	METHOD	METHOD	T
nonnegative_matrix_factorization	METHOD	METHOD	T
non_negative_matrix_factorization	METHOD	METHOD	T
non-negative_matrix_factorization	METHOD	METHOD	T
PMF	METHOD	METHOD	T
probabilistic_matrix_factorization	METHOD	METHOD	T
tensor_factorization	METHOD	METHOD	T
tensor_decomposition	METHOD	METHOD	T
PARAFAC	METHOD	METHOD	T
rand_index	METRIC	METRIC	T
adjusted_rand_index	METRIC	METRIC	T
NMI	METRIC	METRIC	T
normalized_mutual_information	METRIC	METRIC	T
purity	METRIC	METRIC	T
outlier_detection	PROBLEM	PROBLEM	T
outlier_analysis	PROBLEM	PROBLEM	T
anomaly_detection	PROBLEM	PROBLEM	T
visualization	PROBLEM	PROBLEM	T
dimensionality_reduction	PROBLEM	PROBLEM	T
feature_reduction	PROBLEM	PROBLEM	T
feature_selection	PROBLEM	PROBLEM	T
feature_extraction	PROBLEM	PROBLEM	T
similarity_search	PROBLEM	PROBLEM	T
recommender_systems	PROBLEM	PROBLEM	T
recommendation	PROBLEM	PROBLEM	T
recommendation_systems	PROBLEM	PROBLEM	T
link_recommendation	PROBLEM	PROBLEM	T
link_prediction	PROBLEM	PROBLEM	T
link_detection	PROBLEM	PROBLEM	T
machine_learning	PROBLEM	PROBLEM	T
supervised_learning	METHOD	METHOD	T
supervised	METHOD	METHOD	T
semi-supervised_learning	METHOD	METHOD	T
semi_supervised_learning	METHOD	METHOD	T
semi-supervised	METHOD	METHOD	T
semi_supervised	METHOD	METHOD	T
unsupervised_learning	METHOD	METHOD	T
unsupervised	METHOD	METHOD	T
artificial_intelligence	PROBLEM	PROBLEM	T
knowledge_discovery	PROBLEM	PROBLEM	T
# F|8 T|207	0.9627906976744186
